SimulationTime,Episode,TotalVehicles,VehiclesWaiting,QueueLength,AverageWaitTime,Throughput,CurrentPhase,PhaseGreenTime,PhaseDuration,FuelConsumed,VehiclesDeparted,TrafficDensity
10.24738,1,2,2,2,0,0.1951719,1,20,20,0,0,2
20.84221,1,3,3,3,0,0.1439387,2,30,30,0,0,3
31.60168,1,5,5,5,0,0.1582195,2,30,30,0,0,5
43.37792,2,6,6,6,0,0.6428756,2,30,30,0,0,6
56.04203,2,7,6,6,0,0.3182226,0,40,40,0,1,7
68.04204,2,9,1,1,0,0.2647278,0,40,40,0,8,9
80.57155,2,11,2,2,0,0.2364234,0,40,40,0,9,11
93.6802,2,12,2,2,0,0.201223,1,20,20,0,10,12
103.6802,2,13,3,3,0,0.1866868,1,20,20,0,10,13
116.5959,3,14,4,4,0,2.209118,2,30,30,0,10,14
126.5959,3,15,5,5,0,0.9181404,2,30,30,0,10,15
136.5959,3,17,7,7,0,0.6454706,2,30,30,0,10,17
146.5959,3,18,8,8,0,0.4953578,2,30,30,0,10,18
156.5959,3,19,2,2,0,0.4100362,0,40,40,0,17,19
166.5959,3,20,1,1,0,0.3550041,0,40,40,0,19,20
177.9208,3,21,1,1,0,0.3103649,0,40,40,0,20,21
187.9208,3,22,2,2,0,0.2832778,1,20,20,0,20,22
200.8713,3,24,4,4,0,0.2648634,1,20,20,0,20,24
214.1754,4,25,5,5,0,3.749997,2,30,30,0,20,25
224.1754,4,27,7,7,0,1.62,2,30,30,0,20,27
234.1754,4,28,8,8,0,1.05,2,30,30,0,20,28
244.1754,4,30,10,10,0,0.8181817,0,40,40,0,20,30
254.1754,4,31,2,2,0,0.6642857,0,40,40,0,29,31
264.1754,4,32,1,1,0,0.5647058,0,40,40,0,31,32
274.1754,4,33,1,1,0,0.495,1,20,20,0,32,33
284.1754,4,34,2,2,0,0.4434782,1,20,20,0,32,34
294.1754,4,35,3,3,0,0.4038461,1,20,20,0,32,35
304.1754,4,37,5,5,0,0.3827586,2,30,30,0,32,37
314.1754,5,38,2,2,0,5.700009,2,30,30,0,36,38
324.1754,5,39,3,3,0,2.340001,2,30,30,0,36,39
334.1754,5,40,4,4,0,1.500001,0,40,40,0,36,40
344.1754,5,41,1,1,0,1.118182,0,40,40,0,40,41
357.0284,5,42,1,1,0,0.8481486,0,40,40,0,41,42
370.3091,5,43,1,1,0,0.6847095,1,20,20,0,42,43
380.3091,5,45,3,3,0,0.6181288,1,20,20,0,42,45
390.3091,5,46,4,4,0,0.5555532,1,20,20,0,42,46
400.3091,5,47,4,4,0,0.5064636,2,30,30,0,43,47
410.3091,6,48,5,5,0,14.40009,2,30,30,0,43,48
420.3091,6,49,6,6,0,3.675006,2,30,30,0,43,49
430.3091,6,50,5,5,0,2.142859,0,40,40,0,45,50
440.3091,6,51,1,1,0,1.530001,0,40,40,0,50,51
453.049,6,53,1,1,0,1.150344,0,40,40,0,52,53
463.049,6,54,2,2,0,0.9630272,1,20,20,0,52,54
473.049,6,55,3,3,0,0.8324103,1,20,20,0,52,55
483.049,6,57,5,5,0,0.7492785,1,20,20,0,52,57
493.049,6,58,5,5,0,0.6738452,2,30,30,0,53,58
503.049,6,59,6,6,0,0.6141152,2,30,30,0,53,59
513.049,7,60,7,7,0,8.999972,2,30,30,0,53,60
523.049,7,61,6,6,0,3.659996,0,40,40,0,55,61
533.049,7,62,1,1,0,2.324998,0,40,40,0,61,62
543.049,7,63,1,1,0,1.718181,0,40,40,0,62,63
553.049,7,64,1,1,0,1.371428,1,20,20,0,63,64
563.049,7,65,2,2,0,1.147058,1,20,20,0,63,65
573.049,7,66,3,3,0,0.9899997,1,20,20,0,63,66
583.049,7,68,4,4,0,0.8869563,2,30,30,0,64,68
593.049,7,69,5,5,0,0.7961537,2,30,30,0,64,69
603.049,7,71,7,7,0,0.7344826,2,30,30,0,64,71
613.049,8,72,5,5,0,10.79997,0,40,40,0,67,72
623.049,8,73,1,1,0,4.379995,0,40,40,0,72,73
633.049,8,75,2,2,0,2.812498,0,40,40,0,73,75
643.049,8,76,2,2,0,2.072726,1,20,20,0,74,76
653.049,8,77,3,3,0,1.649999,1,20,20,0,74,77
663.049,8,78,4,4,0,1.37647,1,20,20,0,74,78
673.049,8,80,5,5,0,1.2,2,30,30,0,75,80
683.049,8,81,6,6,0,1.056521,2,30,30,0,75,81
693.049,8,82,7,7,0,0.9461536,2,30,30,0,75,82
703.049,8,83,6,6,0,0.8586205,0,40,40,0,77,83
713.049,9,84,1,1,0,12.59996,0,40,40,0,83,84
723.049,9,86,2,2,0,5.159994,0,40,40,0,84,86
733.049,9,87,2,2,0,3.262497,1,20,20,0,85,87
743.049,9,89,4,4,0,2.427271,1,20,20,0,85,89
753.049,9,90,5,5,0,1.928571,1,20,20,0,85,90
763.049,9,91,6,6,0,1.605882,2,30,30,0,85,91
773.049,9,92,7,7,0,1.38,2,30,30,0,85,92
783.049,9,93,8,8,0,1.213043,2,30,30,0,85,93
793.049,9,94,6,6,0,1.084615,0,40,40,0,88,94
803.049,9,95,1,1,0,0.9827584,0,40,40,0,94,95
813.049,10,96,1,1,0,14.39996,0,40,40,0,95,96
823.049,10,97,1,1,0,5.819993,1,20,20,0,96,97
833.049,10,99,3,3,0,3.712497,1,20,20,0,96,99
843.049,10,100,4,4,0,2.727271,1,20,20,0,96,100
853.049,10,101,5,5,0,2.164285,2,30,30,0,96,101
863.049,10,103,7,7,0,1.817646,2,30,30,0,96,103
873.049,10,104,8,8,0,1.559999,2,30,30,0,96,104
883.049,10,105,6,6,0,1.369565,0,40,40,0,99,105
893.049,10,107,2,2,0,1.234615,0,40,40,0,105,107
903.049,10,108,1,1,0,1.117241,0,40,40,0,107,108
913.049,11,109,2,2,0,16.34995,1,20,20,0,107,109
923.049,11,110,3,3,0,6.599992,1,20,20,0,107,110
933.049,11,111,4,4,0,4.162497,1,20,20,0,107,111
943.049,11,113,6,6,0,3.081816,2,30,30,0,107,113
953.049,11,114,7,7,0,2.442856,2,30,30,0,107,114
963.049,11,115,8,8,0,2.029411,2,30,30,0,107,115
973.049,11,116,6,6,0,1.739999,0,40,40,0,110,116
983.049,11,118,2,2,0,1.53913,0,40,40,0,116,118
993.049,11,119,1,1,0,1.373077,0,40,40,0,118,119
1003.049,11,120,1,1,0,1.241379,1,20,20,0,119,120
1013.049,12,121,2,2,0,18.14994,1,20,20,0,119,121
1023.049,12,122,3,3,0,7.319991,1,20,20,0,119,122
1033.049,12,123,2,2,0,4.612486,2,30,30,0,121,123
1043.049,12,125,4,4,0,3.409083,2,30,30,0,121,125
1053.049,12,126,5,5,0,2.699995,2,30,30,0,121,126
1063.049,12,127,3,3,0,2.241173,0,40,40,0,124,127
1073.049,12,128,1,1,0,1.919998,0,40,40,0,127,128
1083.049,12,129,1,1,0,1.682607,0,40,40,0,128,129
1093.049,12,130,2,2,0,1.499999,1,20,20,0,128,130
1103.049,12,131,3,3,0,1.355171,1,20,20,0,128,131
1113.049,13,133,5,5,0,19.94976,1,20,20,0,128,133
1123.049,13,134,5,5,0,8.039961,2,30,30,0,129,134
1133.049,13,135,6,6,0,5.062485,2,30,30,0,129,135
1143.049,13,136,7,7,0,3.709083,2,30,30,0,129,136
1153.049,13,137,5,5,0,2.935709,0,40,40,0,132,137
1163.049,13,139,2,2,0,2.452938,0,40,40,0,137,139
1173.049,13,140,1,1,0,2.099998,0,40,40,0,139,140
1183.049,13,141,2,2,0,1.839128,1,20,20,0,139,141
1193.049,13,142,3,3,0,1.63846,1,20,20,0,139,142
1203.049,13,143,4,4,0,1.479309,1,20,20,0,139,143
1213.049,14,144,5,5,0,21.59974,2,30,30,0,139,144
1223.049,14,146,7,7,0,8.759957,2,30,30,0,139,146
1233.049,14,147,8,8,0,5.512483,2,30,30,0,139,147
1243.049,14,148,5,5,0,4.036355,0,40,40,0,143,148
1253.049,14,150,2,2,0,3.21428,0,40,40,0,148,150
1263.049,14,151,1,1,0,2.664702,0,40,40,0,150,151
1273.049,14,152,2,2,0,2.279997,1,20,20,0,150,152
1283.049,14,153,3,3,0,1.99565,1,20,20,0,150,153
1293.049,14,154,4,4,0,1.776921,1,20,20,0,150,154
1303.049,14,155,5,5,0,1.603447,2,30,30,0,150,155
1313.049,15,156,6,6,0,23.39971,2,30,30,0,150,156
1323.049,15,157,7,7,0,9.419954,2,30,30,0,150,157
1333.049,15,159,5,5,0,5.962482,0,40,40,0,154,159
1343.049,15,160,1,1,0,4.363626,0,40,40,0,159,160
1353.049,15,161,1,1,0,3.449994,0,40,40,0,160,161
1363.049,15,162,2,2,0,2.858819,1,20,20,0,160,162
1373.049,15,163,3,3,0,2.444997,1,20,20,0,160,163
1383.049,15,164,4,4,0,2.139128,1,20,20,0,160,164
1393.049,15,166,6,6,0,1.915383,2,30,30,0,160,166
1403.049,15,167,7,7,0,1.727585,2,30,30,0,160,167
1413.049,16,169,9,9,0,25.34969,2,30,30,0,160,169
1423.049,16,170,8,8,0,10.19995,0,40,40,0,162,170
1433.049,16,171,1,1,0,6.41248,0,40,40,0,170,171
1443.049,16,172,1,1,0,4.690899,0,40,40,0,171,172
1453.049,16,173,1,1,0,3.707136,1,20,20,0,172,173
1463.049,16,174,2,2,0,3.070584,1,20,20,0,172,174
1473.049,16,175,3,3,0,2.624997,1,20,20,0,172,175
1483.049,16,176,4,4,0,2.29565,2,30,30,0,172,176
1493.049,16,178,6,6,0,2.053844,2,30,30,0,172,178
1503.049,16,179,7,7,0,1.851723,2,30,30,0,172,179
1513.049,17,181,7,7,0,27.14967,0,40,40,0,174,181
1523.049,17,182,1,1,0,10.91995,0,40,40,0,181,182
1533.049,17,183,1,1,0,6.862479,0,40,40,0,182,183
1543.049,17,185,2,2,0,5.045444,1,20,20,0,183,185
1553.049,17,186,3,3,0,3.985707,1,20,20,0,183,186
1563.049,17,187,4,4,0,3.299995,1,20,20,0,183,187
1573.049,17,189,5,5,0,2.834996,2,30,30,0,184,189
1583.049,17,190,6,6,0,2.478258,2,30,30,0,184,190
1593.049,17,192,8,8,0,2.215383,2,30,30,0,184,192
1603.049,17,193,6,6,0,1.99655,0,40,40,0,187,193
1613.049,18,194,1,1,0,29.09965,0,40,40,0,193,194
1623.049,18,195,1,1,0,11.69994,0,40,40,0,194,195
1633.049,18,196,1,1,0,7.349977,1,20,20,0,195,196
1643.049,18,197,2,2,0,5.372715,1,20,20,0,195,197
1653.049,18,199,4,4,0,4.264278,1,20,20,0,195,199
1663.049,18,200,4,4,0,3.529407,2,30,30,0,196,200
1673.049,18,201,5,5,0,3.014996,2,30,30,0,196,201
1683.049,18,203,7,7,0,2.647823,2,30,30,0,196,203
1693.049,18,204,5,5,0,2.353844,0,40,40,0,199,204
1703.049,18,205,1,1,0,2.120688,0,40,40,0,204,205
1713.049,19,206,1,1,0,30.89962,0,40,40,0,205,206
1723.049,19,207,1,1,0,12.41994,1,20,20,0,206,207
1733.049,19,208,2,2,0,7.799976,1,20,20,0,206,208
1743.049,19,209,3,3,0,5.699987,1,20,20,0,206,209
1753.049,19,210,4,4,0,4.499992,2,30,30,0,206,210
1763.049,19,211,5,5,0,3.723524,2,30,30,0,206,211
1773.049,19,212,6,6,0,3.179996,2,30,30,0,206,212
1783.049,19,214,6,6,0,2.791301,0,40,40,0,208,214
1793.049,19,215,1,1,0,2.480767,0,40,40,0,214,215
1803.049,19,216,1,1,0,2.234481,0,40,40,0,215,216
1813.049,20,217,1,1,0,32.5496,1,20,20,0,216,217
1823.049,20,218,2,2,0,13.07994,1,20,20,0,216,218
1833.049,20,220,4,4,0,8.249975,1,20,20,0,216,220
1843.049,20,221,4,4,0,6.027259,2,30,30,0,217,221
1853.049,20,222,5,5,0,4.757134,2,30,30,0,217,222
1863.049,20,223,6,6,0,3.935288,2,30,30,0,217,223
1873.049,20,224,4,4,0,3.359996,0,40,40,0,220,224
1883.049,20,225,1,1,0,2.934779,0,40,40,0,224,225
1893.049,20,226,1,1,0,2.60769,0,40,40,0,225,226
1903.049,20,228,2,2,0,2.358619,1,20,20,0,226,228
1913.049,21,229,3,3,0,34.35021,1,20,20,0,226,229
1923.049,21,230,4,4,0,13.80003,1,20,20,0,226,230
1933.049,21,231,5,5,0,8.662513,2,30,30,0,226,231
1943.049,21,232,6,6,0,6.32728,2,30,30,0,226,232
1953.049,21,233,7,7,0,4.992861,2,30,30,0,226,233
1963.049,21,235,6,6,0,4.147062,0,40,40,0,229,235
1973.049,21,236,1,1,0,3.540002,0,40,40,0,235,236
1983.049,21,237,1,1,0,3.091306,0,40,40,0,236,237
1993.049,21,239,2,2,0,2.757694,1,20,20,0,237,239
2003.049,21,240,3,3,0,2.48276,1,20,20,0,237,240
2013.049,22,241,4,4,0,36.15022,1,20,20,0,237,241
2023.049,22,242,3,3,0,14.52004,2,30,30,0,239,242
2033.049,22,243,4,4,0,9.112514,2,30,30,0,239,243
2043.049,22,245,6,6,0,6.681826,2,30,30,0,239,245
2053.049,22,246,4,4,0,5.271433,0,40,40,0,242,246
2063.049,22,247,1,1,0,4.358827,0,40,40,0,246,247
2073.049,22,248,1,1,0,3.720002,0,40,40,0,247,248
2083.049,22,249,1,1,0,3.247828,1,20,20,0,248,249
2093.049,22,250,2,2,0,2.884617,1,20,20,0,248,250
2103.049,22,251,3,3,0,2.596553,1,20,20,0,248,251
2113.049,23,253,4,4,0,37.94954,2,30,30,0,249,253
2123.049,23,254,5,5,0,15.23993,2,30,30,0,249,254
2133.049,23,255,6,6,0,9.56247,2,30,30,0,249,255
2143.049,23,256,4,4,0,6.981802,0,40,40,0,252,256
2153.049,23,257,1,1,0,5.507133,0,40,40,0,256,257
2163.049,23,258,1,1,0,4.552935,0,40,40,0,257,258
2173.049,23,259,1,1,0,3.884995,1,20,20,0,258,259
2183.049,23,261,3,3,0,3.404344,1,20,20,0,258,261
2193.049,23,262,4,4,0,3.023074,1,20,20,0,258,262
2203.049,23,264,6,6,0,2.731032,2,30,30,0,258,264
2213.049,24,265,7,7,0,39.74952,2,30,30,0,258,265
2223.049,24,266,8,8,0,15.95992,2,30,30,0,258,266
2233.049,24,267,6,6,0,10.01247,0,40,40,0,261,267
2243.049,24,268,1,1,0,7.309075,0,40,40,0,267,268
2253.049,24,270,2,2,0,5.785704,0,40,40,0,268,270
2263.049,24,271,2,2,0,4.782346,1,20,20,0,269,271
2273.049,24,272,3,3,0,4.079995,1,20,20,0,269,272
2283.049,24,273,4,4,0,3.560866,1,20,20,0,269,273
2293.049,24,275,2,2,0,3.173074,2,30,30,0,273,275
2303.049,24,276,3,3,0,2.85517,2,30,30,0,273,276
2313.049,25,277,4,4,0,41.54949,2,30,30,0,273,277
2323.049,25,278,2,2,0,16.67992,0,40,40,0,276,278
2333.049,25,279,1,1,0,10.46247,0,40,40,0,278,279
2343.049,25,280,1,1,0,7.636347,0,40,40,0,279,280
2353.049,25,281,1,1,0,6.021418,1,20,20,0,280,281
2363.049,25,283,3,3,0,4.994111,1,20,20,0,280,283
2373.049,25,284,4,4,0,4.259995,1,20,20,0,280,284
2383.049,25,285,5,5,0,3.717387,2,30,30,0,280,285
2393.049,25,286,6,6,0,3.299997,2,30,30,0,280,286
2403.049,25,287,7,7,0,2.968963,2,30,30,0,280,287
2413.049,26,288,4,4,0,43.19947,0,40,40,0,284,288
2423.049,26,289,1,1,0,17.33992,0,40,40,0,288,289
2433.049,26,290,1,1,0,10.87497,0,40,40,0,289,290
2443.049,26,292,2,2,0,7.963619,1,20,20,0,290,292
2453.049,26,293,3,3,0,6.278561,1,20,20,0,290,293
2463.049,26,294,4,4,0,5.188228,1,20,20,0,290,294
2473.049,26,295,4,4,0,4.424994,2,30,30,0,291,295
2483.049,26,296,5,5,0,3.860865,2,30,30,0,291,296
2493.049,26,297,6,6,0,3.42692,2,30,30,0,291,297
2503.049,26,298,5,5,0,3.082756,0,40,40,0,293,298
2513.049,27,299,1,1,0,44.84945,0,40,40,0,298,299
2523.049,27,301,2,2,0,18.05991,0,40,40,0,299,301
2533.049,27,302,2,2,0,11.32497,1,20,20,0,300,302
2543.049,27,303,3,3,0,8.263618,1,20,20,0,300,303
2553.049,27,304,4,4,0,6.514274,1,20,20,0,300,304
2563.049,27,305,5,5,0,5.382345,2,30,30,0,300,305
2573.049,27,306,6,6,0,4.589994,2,30,30,0,300,306
2583.049,27,307,7,7,0,4.004344,2,30,30,0,300,307
2593.049,27,308,5,5,0,3.553843,0,40,40,0,303,308
2603.049,27,309,1,1,0,3.196549,0,40,40,0,308,309
2613.049,28,311,2,2,0,46.64943,0,40,40,0,309,311
2623.049,28,312,2,2,0,18.71991,1,20,20,0,310,312
2633.049,28,313,3,3,0,11.73746,1,20,20,0,310,313
2643.049,28,315,5,5,0,8.59089,1,20,20,0,310,315
2653.049,28,316,6,6,0,6.771417,2,30,30,0,310,316
2663.049,28,317,7,7,0,5.59411,2,30,30,0,310,317
2673.049,28,318,8,8,0,4.769994,2,30,30,0,310,318
2683.049,28,320,6,6,0,4.173909,0,40,40,0,314,320
2693.049,28,321,1,1,0,3.703843,0,40,40,0,320,321
2703.049,28,322,1,1,0,3.331032,0,40,40,0,321,322
2713.049,29,323,1,1,0,48.44941,1,20,20,0,322,323
2723.049,29,324,2,2,0,19.43991,1,20,20,0,322,324
2733.049,29,326,4,4,0,12.22496,1,20,20,0,322,326
2743.049,29,327,4,4,0,8.918162,2,30,30,0,323,327
2753.049,29,328,5,5,0,7.028559,2,30,30,0,323,328
2763.049,29,329,6,6,0,5.805874,2,30,30,0,323,329
2773.049,29,330,3,3,0,4.949994,0,40,40,0,327,330
2783.049,29,332,2,2,0,4.33043,0,40,40,0,330,332
2793.049,29,333,1,1,0,3.842304,0,40,40,0,332,333
2803.049,29,334,1,1,0,3.455169,1,20,20,0,333,334
2813.049,30,335,2,2,0,50.24939,1,20,20,0,333,335
2823.049,30,337,4,4,0,20.2199,1,20,20,0,333,337
2833.049,30,338,4,4,0,12.67496,2,30,30,0,334,338
2843.049,30,339,5,5,0,9.245434,2,30,30,0,334,339
2853.049,30,340,6,6,0,7.285702,2,30,30,0,334,340
2863.049,30,342,5,5,0,6.035285,0,40,40,0,337,342
2873.049,30,343,1,1,0,5.144994,0,40,40,0,342,343
2883.049,30,344,1,1,0,4.486952,0,40,40,0,343,344
2893.049,30,346,2,2,0,3.992304,1,20,20,0,344,346
2903.049,30,347,3,3,0,3.589652,1,20,20,0,344,347
2913.049,31,348,4,4,0,52.19936,1,20,20,0,344,348
2923.049,31,349,4,4,0,20.9399,2,30,30,0,345,349
2933.049,31,350,5,5,0,13.12496,2,30,30,0,345,350
2943.049,31,351,6,6,0,9.572706,2,30,30,0,345,351
2953.049,31,352,3,3,0,7.542844,0,40,40,0,349,352
2963.049,31,353,1,1,0,6.229403,0,40,40,0,352,353
2973.049,31,354,1,1,0,5.309994,0,40,40,0,353,354
2983.049,31,355,2,2,0,4.63043,1,20,20,0,353,355
2993.049,31,356,3,3,0,4.107688,1,20,20,0,353,356
3003.049,31,357,4,4,0,3.6931,1,20,20,0,353,357
3013.049,32,358,5,5,0,53.69934,2,30,30,0,353,358
3023.049,32,359,6,6,0,21.53989,2,30,30,0,353,359
3033.049,32,361,8,8,0,13.53746,2,30,30,0,353,361
3043.049,32,362,6,6,0,9.872705,0,40,40,0,356,362
3053.049,32,363,1,1,0,7.778558,0,40,40,0,362,363
3063.049,32,364,1,1,0,6.42352,0,40,40,0,363,364
3073.049,32,365,1,1,0,5.474993,1,20,20,0,364,365
3083.049,32,367,3,3,0,4.786952,1,20,20,0,364,367
3093.049,32,368,4,4,0,4.24615,1,20,20,0,364,368
3103.049,32,369,2,2,0,3.817238,2,30,30,0,367,369
3113.049,33,371,4,4,0,55.64932,2,30,30,0,367,371
3123.049,33,372,5,5,0,22.31989,2,30,30,0,367,372
3133.049,33,373,3,3,0,13.98746,0,40,40,0,370,373
3143.049,33,374,1,1,0,10.19998,0,40,40,0,373,374
3153.049,33,375,1,1,0,8.0357,0,40,40,0,374,375
3163.049,33,376,1,1,0,6.635284,1,20,20,0,375,376
3173.049,33,377,2,2,0,5.654993,1,20,20,0,375,377
3183.049,33,378,3,3,0,4.930429,1,20,20,0,375,378
3193.049,33,379,3,3,0,4.373073,2,30,30,0,376,379
3203.049,33,381,5,5,0,3.941376,2,30,30,0,376,381
3213.049,34,382,6,6,0,57.3014,2,30,30,0,376,382
3223.049,34,383,4,4,0,22.98022,0,40,40,0,379,383
3233.049,34,384,1,1,0,14.40009,0,40,40,0,383,384
3243.049,34,385,1,1,0,10.50005,0,40,40,0,384,385
3253.049,34,386,1,1,0,8.271458,1,20,20,0,385,386
3263.049,34,387,2,2,0,6.829432,1,20,20,0,385,387
3273.049,34,388,3,3,0,5.820014,1,20,20,0,385,388
3283.049,34,389,3,3,0,5.073924,2,30,30,0,386,389
3293.049,34,391,5,5,0,4.511547,2,30,30,0,386,391
3303.049,34,392,6,6,0,4.055179,2,30,30,0,386,392
3313.049,35,393,3,3,0,58.95144,0,40,40,0,390,393
3323.049,35,394,1,1,0,23.64023,0,40,40,0,393,394
3333.049,35,396,2,2,0,14.85009,0,40,40,0,394,396
3343.049,35,397,2,2,0,10.82732,1,20,20,0,395,397
3353.049,35,399,4,4,0,8.55003,1,20,20,0,395,399
3363.049,35,400,5,5,0,7.058844,1,20,20,0,395,400
3373.049,35,401,5,5,0,6.015015,2,30,30,0,396,401
3383.049,35,402,6,6,0,5.243489,2,30,30,0,396,402
3393.049,35,403,7,7,0,4.650009,2,30,30,0,396,403
3403.049,35,404,5,5,0,4.179317,0,40,40,0,399,404
3413.049,36,405,1,1,0,60.75148,0,40,40,0,404,405
3423.049,36,407,2,2,0,24.42024,0,40,40,0,405,407
3433.049,36,408,2,2,0,15.30009,1,20,20,0,406,408
3443.049,36,409,3,3,0,11.1546,1,20,20,0,406,409
3453.049,36,411,5,5,0,8.807174,1,20,20,0,406,411
3463.049,36,412,3,3,0,7.270609,2,30,30,0,409,412
3473.049,36,413,4,4,0,6.195015,2,30,30,0,409,413
3483.049,36,414,5,5,0,5.400012,2,30,30,0,409,414
3493.049,36,416,4,4,0,4.800009,0,40,40,0,412,416
3503.049,36,417,1,1,0,4.3138,0,40,40,0,416,417
3513.049,37,418,1,1,0,62.70153,0,40,40,0,417,418
3523.049,37,419,1,1,0,25.14025,1,20,20,0,418,419
3533.049,37,421,3,3,0,15.7876,1,20,20,0,418,421
3543.049,37,422,4,4,0,11.50914,1,20,20,0,418,422
3553.049,37,423,2,2,0,9.064318,2,30,30,0,421,423
3563.049,37,424,2,2,0,7.482375,2,30,30,0,422,424
3573.049,37,425,3,3,0,6.375016,2,30,30,0,422,425
3583.049,37,426,1,1,0,5.556533,0,40,40,0,425,426
3593.049,37,427,1,1,0,4.926932,0,40,40,0,426,427
3603.049,37,428,1,1,0,4.427594,0,40,40,0,427,428
3613.049,38,429,1,1,0,64.35157,1,20,20,0,428,429
3623.049,38,431,3,3,0,25.86025,1,20,20,0,428,431
3633.049,38,432,4,4,0,16.2001,1,20,20,0,428,432
3643.049,38,433,2,2,0,11.80914,2,30,30,0,431,433
3653.049,38,434,3,3,0,9.300033,2,30,30,0,431,434
3663.049,38,435,4,4,0,7.676493,2,30,30,0,431,435
3673.049,38,437,2,2,0,6.555016,0,40,40,0,435,437
3683.049,38,438,1,1,0,5.713056,0,40,40,0,437,438
3693.049,38,439,1,1,0,5.065394,0,40,40,0,438,439
3703.049,38,440,1,1,0,4.551732,1,20,20,0,439,440
3713.049,39,442,3,3,0,66.30162,1,20,20,0,439,442
3723.049,39,443,4,4,0,26.58026,1,20,20,0,439,443
3733.049,39,444,3,3,0,16.6501,2,30,30,0,441,444
3743.049,39,446,5,5,0,12.16369,2,30,30,0,441,446
3753.049,39,447,6,6,0,9.578605,2,30,30,0,441,447
3763.049,39,449,5,5,0,7.923552,0,40,40,0,444,449
3773.049,39,450,1,1,0,6.750017,0,40,40,0,449,450
3783.049,39,451,1,1,0,5.882621,0,40,40,0,450,451
3793.049,39,452,2,2,0,5.215394,1,20,20,0,450,452
3803.049,39,453,3,3,0,4.686215,1,20,20,0,450,453
3813.049,40,454,4,4,0,68.10166,1,20,20,0,450,454
3823.049,40,455,4,4,0,27.30027,2,30,30,0,451,455
3833.049,40,456,5,5,0,17.10011,2,30,30,0,451,456
3843.049,40,458,7,7,0,12.49096,2,30,30,0,451,458
3853.049,40,459,5,5,0,9.835749,0,40,40,0,454,459
3863.049,40,460,1,1,0,8.11767,0,40,40,0,459,460
3873.049,40,462,2,2,0,6.930017,0,40,40,0,460,462
3883.049,40,463,2,2,0,6.039143,1,20,20,0,461,463
3893.049,40,464,3,3,0,5.353856,1,20,20,0,461,464
3903.049,40,465,4,4,0,4.810353,1,20,20,0,461,465
3913.049,41,467,6,6,0,70.05171,2,30,30,0,461,467
3923.049,41,468,7,7,0,28.08027,2,30,30,0,461,468
3933.049,41,469,8,8,0,17.58761,2,30,30,0,461,469
3943.049,41,471,7,7,0,12.84551,0,40,40,0,464,471
3953.049,41,472,1,1,0,10.11432,0,40,40,0,471,472
3963.049,41,473,1,1,0,8.347083,0,40,40,0,472,473
3973.049,41,474,2,2,0,7.110017,1,20,20,0,472,474
3983.049,41,475,3,3,0,6.195665,1,20,20,0,472,475
3993.049,41,476,4,4,0,5.492318,1,20,20,0,472,476
4003.049,41,478,5,5,0,4.944836,2,30,30,0,473,478
4013.049,42,479,6,6,0,71.85175,2,30,30,0,473,479
4023.049,42,480,7,7,0,28.80028,2,30,30,0,473,480
4033.049,42,481,5,5,0,18.03761,0,40,40,0,476,481
4043.049,42,483,2,2,0,13.17279,0,40,40,0,481,483
4053.049,42,484,1,1,0,10.37146,0,40,40,0,483,484
4063.049,42,486,2,2,0,8.576495,1,20,20,0,484,486
4073.049,42,487,3,3,0,7.305018,1,20,20,0,484,487
4083.049,42,488,4,4,0,6.365231,1,20,20,0,484,488
4093.049,42,489,5,5,0,5.642318,2,30,30,0,484,489
4103.049,42,490,6,6,0,5.068961,2,30,30,0,484,490
4113.049,43,492,8,8,0,73.79639,2,30,30,0,484,492
4123.049,43,493,6,6,0,29.57942,0,40,40,0,487,493
4133.049,43,494,1,1,0,18.52477,0,40,40,0,493,494
4143.049,43,496,2,2,0,13.52715,0,40,40,0,494,496
4153.049,43,497,2,2,0,10.64993,1,20,20,0,495,497
4163.049,43,498,3,3,0,8.788185,1,20,20,0,495,498
4173.049,43,500,5,5,0,7.499963,1,20,20,0,495,500
4183.049,43,501,5,5,0,6.534755,2,30,30,0,496,501
4193.049,43,503,7,7,0,5.803824,2,30,30,0,496,503
4203.049,43,504,8,8,0,5.213776,2,30,30,0,496,504
4213.049,44,505,5,5,0,75.7463,0,40,40,0,500,505
4223.049,44,506,1,1,0,30.35941,0,40,40,0,505,506
4233.049,44,507,1,1,0,19.01227,0,40,40,0,506,507
4243.049,44,508,1,1,0,13.85442,1,20,20,0,507,508
4253.049,44,510,3,3,0,10.9285,1,20,20,0,507,510
4263.049,44,511,4,4,0,9.017595,1,20,20,0,507,511
4273.049,44,512,4,4,0,7.679963,2,30,30,0,508,512
4283.049,44,513,5,5,0,6.691276,2,30,30,0,508,513
4293.049,44,514,6,6,0,5.930747,2,30,30,0,508,514
4303.049,44,515,4,4,0,5.327568,0,40,40,0,511,515
4313.049,45,516,1,1,0,77.39622,0,40,40,0,515,516
4323.049,45,518,2,2,0,31.07939,0,40,40,0,516,518
4333.049,45,519,2,2,0,19.46226,1,20,20,0,517,519
4343.049,45,520,3,3,0,14.18169,1,20,20,0,517,520
4353.049,45,522,5,5,0,11.18564,1,20,20,0,517,522
4363.049,45,523,6,6,0,9.229359,2,30,30,0,517,523
4373.049,45,525,8,8,0,7.874961,2,30,30,0,517,525
4383.049,45,526,9,9,0,6.86084,2,30,30,0,517,526
4393.049,45,527,6,6,0,6.080746,0,40,40,0,521,527
4403.049,45,529,2,2,0,5.472395,0,40,40,0,527,529
4413.049,46,530,1,1,0,79.49612,0,40,40,0,529,530
4423.049,46,531,2,2,0,31.85938,1,20,20,0,529,531
4433.049,46,532,3,3,0,19.94976,1,20,20,0,529,532
4443.049,46,533,4,4,0,14.53623,1,20,20,0,529,533
4453.049,46,535,3,3,0,11.46421,2,30,30,0,532,535
4463.049,46,536,4,4,0,9.458769,2,30,30,0,532,536
4473.049,46,537,5,5,0,8.05496,2,30,30,0,532,537
4483.049,46,538,4,4,0,7.017362,0,40,40,0,534,538
4493.049,46,540,2,2,0,6.230746,0,40,40,0,538,540
4503.049,46,541,1,1,0,5.596533,0,40,40,0,540,541
4513.049,47,542,1,1,0,81.29603,1,20,20,0,541,542
4523.049,47,543,2,2,0,32.57936,1,20,20,0,541,543
4533.049,47,545,4,4,0,20.43725,1,20,20,0,541,545
4543.049,47,546,4,4,0,14.89078,2,30,30,0,542,546
4553.049,47,547,5,5,0,11.72135,2,30,30,0,542,547
4563.049,47,548,6,6,0,9.670532,2,30,30,0,542,548
4573.049,47,549,5,5,0,8.23496,0,40,40,0,544,549
4583.049,47,551,2,2,0,7.186926,0,40,40,0,549,551
4593.049,47,552,1,1,0,6.369207,0,40,40,0,551,552
4603.049,47,553,2,2,0,5.72067,1,20,20,0,551,553
4613.049,48,554,3,3,0,83.09594,1,20,20,0,551,554
4623.049,48,556,5,5,0,33.35935,1,20,20,0,551,556
4633.049,48,557,6,6,0,20.88725,2,30,30,0,551,557
4643.049,48,558,7,7,0,15.21805,2,30,30,0,551,558
4653.049,48,559,8,8,0,11.97849,2,30,30,0,551,559
4663.049,48,560,5,5,0,9.882297,0,40,40,0,555,560
4673.049,48,561,1,1,0,8.414959,0,40,40,0,560,561
4683.049,48,562,1,1,0,7.330404,0,40,40,0,561,562
4693.049,48,563,1,1,0,6.49613,1,20,20,0,562,563
4703.049,48,564,2,2,0,5.834463,1,20,20,0,562,564
4713.049,49,565,3,3,0,84.74586,1,20,20,0,562,565
4723.049,49,567,4,4,0,34.01934,2,30,30,0,563,567
4733.049,49,568,5,5,0,21.29974,2,30,30,0,563,568
4743.049,49,569,6,6,0,15.51804,2,30,30,0,563,569
4753.049,49,570,3,3,0,12.2142,0,40,40,0,567,570
4763.049,49,571,1,1,0,10.07641,0,40,40,0,570,571
4773.049,49,572,1,1,0,8.579958,0,40,40,0,571,572
4783.049,49,573,1,1,0,7.473881,1,20,20,0,572,573
4793.049,49,574,2,2,0,6.623052,1,20,20,0,572,574
4803.049,49,575,3,3,0,5.948256,1,20,20,0,572,575
4813.049,50,576,4,4,0,86.39578,2,30,30,0,572,576
4823.049,50,578,6,6,0,34.67932,2,30,30,0,572,578
4833.049,50,579,7,7,0,21.71223,2,30,30,0,572,579
4843.049,50,580,6,6,0,15.81804,0,40,40,0,574,580
4853.049,50,582,2,2,0,12.47134,0,40,40,0,580,582
4863.049,50,583,1,1,0,10.28818,0,40,40,0,582,583
4873.049,50,585,2,2,0,8.774957,1,20,20,0,583,585
4883.049,50,586,3,3,0,7.643446,1,20,20,0,583,586
4893.049,50,588,5,5,0,6.78459,1,20,20,0,583,588
4903.049,50,589,6,6,0,6.093083,2,30,30,0,583,589
4913.049,51,590,7,7,0,88.49568,2,30,30,0,583,590
4923.049,51,591,8,8,0,35.45931,2,30,30,0,583,591
4933.049,51,593,6,6,0,22.23723,0,40,40,0,587,593
4943.049,51,594,1,1,0,16.19986,0,40,40,0,593,594
4953.049,51,595,1,1,0,12.74991,0,40,40,0,594,595
4963.049,51,596,1,1,0,10.51759,1,20,20,0,595,596
4973.049,51,598,3,3,0,8.969956,1,20,20,0,595,598
4983.049,51,599,4,4,0,7.81301,1,20,20,0,595,599
4993.049,51,600,5,5,0,6.923051,2,30,30,0,595,600
5003.049,51,601,6,6,0,6.21722,2,30,30,0,595,601
5013.049,52,602,7,7,0,90.29559,2,30,30,0,595,602
5023.049,52,604,6,6,0,36.23929,0,40,40,0,598,604
5033.049,52,605,1,1,0,22.68722,0,40,40,0,604,605
5043.049,52,606,1,1,0,16.52713,0,40,40,0,605,606
5053.049,52,607,1,1,0,13.00705,1,20,20,0,606,607
5063.049,52,608,2,2,0,10.72935,1,20,20,0,606,608
5073.049,52,609,3,3,0,9.134955,1,20,20,0,606,609
5083.049,52,611,5,5,0,7.969532,2,30,30,0,606,611
5093.049,52,612,6,6,0,7.061512,2,30,30,0,606,612
5103.049,52,614,8,8,0,6.351703,2,30,30,0,606,614
5113.049,53,615,5,5,0,92.2455,0,40,40,0,610,615
5123.049,53,616,1,1,0,36.95928,0,40,40,0,615,616
5133.049,53,618,2,2,0,23.17472,0,40,40,0,616,618
5143.049,53,619,2,2,0,16.88167,1,20,20,0,617,619
5153.049,53,621,4,4,0,13.30705,1,20,20,0,617,621
5163.049,53,622,5,5,0,10.97641,1,20,20,0,617,622
5173.049,53,623,6,6,0,9.344954,2,30,30,0,617,623
5183.049,53,624,7,7,0,8.139096,2,30,30,0,617,624
5193.049,53,625,8,8,0,7.211512,2,30,30,0,617,625
5203.049,53,626,7,7,0,6.47584,0,40,40,0,619,626
5213.049,54,627,1,1,0,94.04541,0,40,40,0,626,627
5223.049,54,629,2,2,0,37.73926,0,40,40,0,627,629
5233.049,54,630,2,2,0,23.62471,1,20,20,0,628,630
5243.049,54,631,3,3,0,17.20894,1,20,20,0,628,631
5253.049,54,632,4,4,0,13.54276,1,20,20,0,628,632
5263.049,54,633,3,3,0,11.17052,2,30,30,0,630,633
5273.049,54,634,1,1,0,9.509953,2,30,30,0,633,634
5283.049,54,635,1,1,0,8.282574,2,30,30,0,634,635
5293.049,54,637,2,2,0,7.349972,0,40,40,0,635,637
5303.049,54,638,1,1,0,6.599978,0,40,40,0,637,638
5313.049,55,639,1,1,0,95.84532,0,40,40,0,638,639
5323.049,55,640,1,1,0,38.39925,1,20,20,0,639,640
5333.049,55,642,3,3,0,24.07471,1,20,20,0,639,642
5343.049,55,643,4,4,0,17.53621,1,20,20,0,639,643
5353.049,55,644,5,5,0,13.7999,2,30,30,0,639,644
5363.049,55,646,7,7,0,11.39993,2,30,30,0,639,646
5373.049,55,647,8,8,0,9.704952,2,30,30,0,639,647
5383.049,55,649,6,6,0,8.465181,0,40,40,0,643,649
5393.049,55,650,1,1,0,7.499972,0,40,40,0,649,650
5403.049,55,651,1,1,0,6.73446,0,40,40,0,650,651
5413.049,56,652,1,1,0,97.79523,1,20,20,0,651,652
5423.049,56,653,2,2,0,39.17923,1,20,20,0,651,653
5433.049,56,654,3,3,0,24.5247,1,20,20,0,651,654
5443.049,56,656,2,2,0,17.89075,2,30,30,0,654,656
5453.049,56,657,3,3,0,14.07847,2,30,30,0,654,657
5463.049,56,658,4,4,0,11.6117,2,30,30,0,654,658
5473.049,56,659,3,3,0,9.884952,0,40,40,0,656,659
5483.049,56,660,1,1,0,8.608659,0,40,40,0,659,660
5493.049,56,661,1,1,0,7.626894,0,40,40,0,660,661
5503.049,56,663,2,2,0,6.858598,1,20,20,0,661,663
5513.049,57,664,3,3,0,99.59514,1,20,20,0,661,664
5523.049,57,665,4,4,0,39.89922,1,20,20,0,661,665
5533.049,57,667,6,6,0,25.0122,2,30,30,0,661,667
5543.049,57,668,7,7,0,18.21802,2,30,30,0,661,668
5553.049,57,669,8,8,0,14.33561,2,30,30,0,661,669
5563.049,57,670,7,7,0,11.82346,0,40,40,0,663,670
5573.049,57,671,1,1,0,10.06495,0,40,40,0,670,671
5583.049,57,672,1,1,0,8.765181,0,40,40,0,671,672
5593.049,57,673,1,1,0,7.765356,1,20,20,0,672,673
5603.049,57,675,3,3,0,6.982735,1,20,20,0,672,675
5613.049,58,676,4,4,0,101.3951,1,20,20,0,672,676
5623.049,58,677,4,4,0,40.61921,2,30,30,0,673,677
5633.049,58,678,5,5,0,25.42469,2,30,30,0,673,678
5643.049,58,679,6,6,0,18.51802,2,30,30,0,673,679
5653.049,58,680,4,4,0,14.57133,0,40,40,0,676,680
5663.049,58,681,1,1,0,12.01758,0,40,40,0,680,681
5673.049,58,683,2,2,0,10.24495,0,40,40,0,681,683
5683.049,58,684,2,2,0,8.921701,1,20,20,0,682,684
5693.049,58,685,3,3,0,7.903817,1,20,20,0,682,685
5703.049,58,686,4,4,0,7.096528,1,20,20,0,682,686
5713.049,59,687,3,3,0,103.045,2,30,30,0,684,687
5723.049,59,689,5,5,0,41.33919,2,30,30,0,684,689
5733.049,59,690,6,6,0,25.87468,2,30,30,0,684,690
5743.049,59,692,4,4,0,18.87256,0,40,40,0,688,692
5753.049,59,693,1,1,0,14.8499,0,40,40,0,692,693
5763.049,59,694,1,1,0,12.24699,0,40,40,0,693,694
5773.049,59,695,2,2,0,10.42495,1,20,20,0,693,695
5783.049,59,696,3,3,0,9.078222,1,20,20,0,693,696
5793.049,59,697,4,4,0,8.042277,1,20,20,0,693,697
5803.049,59,698,5,5,0,7.220665,2,30,30,0,693,698
5813.049,60,700,7,7,0,105.0026,2,30,30,0,693,700
5823.049,60,701,8,8,0,42.06041,2,30,30,0,693,701
5833.049,60,702,6,6,0,26.32516,0,40,40,0,696,702
5843.049,60,703,1,1,0,19.17281,0,40,40,0,702,703
5853.049,60,705,2,2,0,15.1072,0,40,40,0,703,705
5863.049,60,706,2,2,0,12.45886,1,20,20,0,704,706
5873.049,60,707,3,3,0,10.60503,1,20,20,0,704,707
5883.049,60,708,4,4,0,9.234802,1,20,20,0,704,708
5893.049,60,709,3,3,0,8.180784,2,30,30,0,706,709
5903.049,60,710,4,4,0,7.34484,2,30,30,0,706,710
5913.049,61,712,6,6,0,106.8026,2,30,30,0,706,712
5923.049,61,713,4,4,0,42.78042,0,40,40,0,709,713
5933.049,61,714,1,1,0,26.77516,0,40,40,0,713,714
5943.049,61,715,1,1,0,19.50009,0,40,40,0,714,715
5953.049,61,716,2,2,0,15.34291,1,20,20,0,714,716
5963.049,61,717,3,3,0,12.65298,1,20,20,0,714,717
5973.049,61,719,5,5,0,10.78503,1,20,20,0,714,719
5983.049,61,720,6,6,0,9.391324,2,30,30,0,714,720
5993.049,61,722,8,8,0,8.330785,2,30,30,0,714,722
6003.049,61,723,9,9,0,7.479323,2,30,30,0,714,723
6013.049,62,724,7,7,0,108.6027,0,40,40,0,717,724
6023.049,62,725,1,1,0,43.50042,0,40,40,0,724,725
6033.049,62,726,1,1,0,27.22517,0,40,40,0,725,726
6043.049,62,727,1,1,0,19.82736,1,20,20,0,726,727
6053.049,62,728,2,2,0,15.60005,1,20,20,0,726,728
6063.049,62,730,4,4,0,12.88239,1,20,20,0,726,730
6073.049,62,731,5,5,0,10.96503,2,30,30,0,726,731
6083.049,62,732,6,6,0,9.547847,2,30,30,0,726,732
6093.049,62,733,7,7,0,8.457708,2,30,30,0,726,733
6103.049,62,734,4,4,0,7.593116,0,40,40,0,730,734
6113.049,63,735,1,1,0,110.2527,0,40,40,0,734,735
6123.049,63,737,2,2,0,44.22043,0,40,40,0,735,737
6133.049,63,738,2,2,0,27.67517,1,20,20,0,736,738
6143.049,63,739,3,3,0,20.15463,1,20,20,0,736,739
6153.049,63,740,4,4,0,15.8572,1,20,20,0,736,740
6163.049,63,741,4,4,0,13.07651,2,30,30,0,737,741
6173.049,63,742,5,5,0,11.13003,2,30,30,0,737,742
6183.049,63,744,7,7,0,9.704369,2,30,30,0,737,744
6193.049,63,745,5,5,0,8.59617,0,40,40,0,740,745
6203.049,63,746,1,1,0,7.717254,0,40,40,0,745,746
6213.049,64,747,1,1,0,112.0527,0,40,40,0,746,747
6223.049,64,748,1,1,0,44.88044,1,20,20,0,747,748
6233.049,64,749,2,2,0,28.08767,1,20,20,0,747,749
6243.049,64,750,3,3,0,20.45464,1,20,20,0,747,750
6253.049,64,751,4,4,0,16.09291,2,30,30,0,747,751
6263.049,64,752,5,5,0,13.27063,2,30,30,0,747,752
6273.049,64,753,6,6,0,11.29503,2,30,30,0,747,753
6283.049,64,754,4,4,0,9.834804,0,40,40,0,750,754
6293.049,64,755,1,1,0,8.711555,0,40,40,0,754,755
6303.049,64,757,2,2,0,7.831048,0,40,40,0,755,757
6313.049,65,758,2,2,0,113.7028,1,20,20,0,756,758
6323.049,65,759,3,3,0,45.54044,1,20,20,0,756,759
6333.049,65,760,4,4,0,28.50017,1,20,20,0,756,760
6343.049,65,761,4,4,0,20.75464,2,30,30,0,757,761
6353.049,65,762,5,5,0,16.32863,2,30,30,0,757,762
6363.049,65,764,7,7,0,13.48239,2,30,30,0,757,764
6373.049,65,765,5,5,0,11.47503,0,40,40,0,760,765
6383.049,65,766,1,1,0,9.991325,0,40,40,0,765,766
6393.049,65,768,2,2,0,8.861555,0,40,40,0,766,768
6403.049,65,769,2,2,0,7.955186,1,20,20,0,767,769
6413.049,66,770,3,3,0,115.5028,1,20,20,0,767,770
6423.049,66,772,5,5,0,46.32045,1,20,20,0,767,772
6433.049,66,773,6,6,0,28.98768,2,30,30,0,767,773
6443.049,66,774,7,7,0,21.10918,2,30,30,0,767,774
6453.049,66,775,8,8,0,16.6072,2,30,30,0,767,775
6463.049,66,776,7,7,0,13.69416,0,40,40,0,769,776
6473.049,66,778,2,2,0,11.67003,0,40,40,0,776,778
6483.049,66,779,1,1,0,10.16089,0,40,40,0,778,779
6493.049,66,780,1,1,0,9.000017,1,20,20,0,779,780
6503.049,66,782,3,3,0,8.089669,1,20,20,0,779,782
6513.049,67,783,4,4,0,117.4529,1,20,20,0,779,783
6523.049,67,784,4,4,0,47.04046,2,30,30,0,780,784
6533.049,67,786,6,6,0,29.47518,2,30,30,0,780,786
6543.049,67,787,7,7,0,21.46373,2,30,30,0,780,787
6553.049,67,788,5,5,0,16.88577,0,40,40,0,783,788
6563.049,67,789,1,1,0,13.92357,0,40,40,0,788,789
6573.049,67,791,2,2,0,11.86503,0,40,40,0,789,791
6583.049,67,792,2,2,0,10.33046,1,20,20,0,790,792
6593.049,67,793,3,3,0,9.150017,1,20,20,0,790,793
6603.049,67,794,4,4,0,8.213807,1,20,20,0,790,794
6613.049,68,795,4,4,0,119.2529,2,30,30,0,791,795
6623.049,68,796,5,5,0,47.76047,2,30,30,0,791,796
6633.049,68,798,7,7,0,29.92518,2,30,30,0,791,798
6643.049,68,799,5,5,0,21.79101,0,40,40,0,794,799
6653.049,68,800,1,1,0,17.14292,0,40,40,0,799,800
6663.049,68,801,1,1,0,14.13533,0,40,40,0,800,801
6673.049,68,802,1,1,0,12.03003,1,20,20,0,801,802
6683.049,68,804,3,3,0,10.48698,1,20,20,0,801,804
6693.049,68,805,4,4,0,9.288479,1,20,20,0,801,805
6703.049,68,806,2,2,0,8.337945,2,30,30,0,804,806
6713.049,69,807,3,3,0,121.053,2,30,30,0,804,807
6723.049,69,808,4,4,0,48.48047,2,30,30,0,804,808
6733.049,69,809,3,3,0,30.33768,0,40,40,0,806,809
6743.049,69,810,1,1,0,22.09101,0,40,40,0,809,810
6753.049,69,811,1,1,0,17.37863,0,40,40,0,810,811
6763.049,69,812,1,1,0,14.32945,1,20,20,0,811,812
6773.049,69,814,3,3,0,12.21003,1,20,20,0,811,814
6783.049,69,815,4,4,0,10.63046,1,20,20,0,811,815
6793.049,69,816,5,5,0,9.415402,2,30,30,0,811,816
6803.049,69,818,7,7,0,8.462083,2,30,30,0,811,818
6813.049,70,819,8,8,0,122.853,2,30,30,0,811,819
6823.049,70,820,5,5,0,49.20048,0,40,40,0,815,820
6833.049,70,821,1,1,0,30.78769,0,40,40,0,820,821
6843.049,70,822,1,1,0,22.41828,0,40,40,0,821,822
6853.049,70,823,1,1,0,17.63578,1,20,20,0,822,823
6863.049,70,825,3,3,0,14.55887,1,20,20,0,822,825
6873.049,70,826,4,4,0,12.39003,1,20,20,0,822,826
6883.049,70,827,4,4,0,10.78698,2,30,30,0,823,827
6893.049,70,829,6,6,0,9.565403,2,30,30,0,823,829
6903.049,70,830,7,7,0,8.586222,2,30,30,0,823,830
6913.049,71,831,5,5,0,124.653,0,40,40,0,826,831
6923.049,71,832,1,1,0,49.92049,0,40,40,0,831,832
6933.049,71,834,2,2,0,31.27519,0,40,40,0,832,834
6943.049,71,835,2,2,0,22.77283,1,20,20,0,833,835
6953.049,71,836,3,3,0,17.91435,1,20,20,0,833,836
6963.049,71,838,5,5,0,14.78828,1,20,20,0,833,838
6973.049,71,839,4,4,0,12.58503,2,30,30,0,835,839
6983.049,71,840,5,5,0,10.95654,2,30,30,0,835,840
6993.049,71,842,7,7,0,9.715403,2,30,30,0,835,842
7003.049,71,843,5,5,0,8.720704,0,40,40,0,838,843
7013.049,72,844,1,1,0,126.6031,0,40,40,0,843,844
7023.049,72,845,1,1,0,50.7005,0,40,40,0,844,845
7033.049,72,847,2,2,0,31.76269,1,20,20,0,845,847
7043.049,72,848,3,3,0,23.12737,1,20,20,0,845,848
7053.049,72,849,4,4,0,18.19292,1,20,20,0,845,849
7063.049,72,851,5,5,0,15.01769,2,30,30,0,846,851
7073.049,72,852,6,6,0,12.78003,2,30,30,0,846,852
7083.049,72,853,7,7,0,11.12611,2,30,30,0,846,853
7093.049,72,854,5,5,0,9.853865,0,40,40,0,849,854
7103.049,72,856,2,2,0,8.855187,0,40,40,0,854,856
7113.049,73,857,1,1,0,128.5531,0,40,40,0,856,857
7123.049,73,858,2,2,0,51.4805,1,20,20,0,856,858
7133.049,73,859,3,3,0,32.2127,1,20,20,0,856,859
7143.049,73,860,4,4,0,23.45465,1,20,20,0,856,860
7153.049,73,861,3,3,0,18.45006,2,30,30,0,858,861
7163.049,73,862,4,4,0,15.21181,2,30,30,0,858,862
7173.049,73,863,5,5,0,12.94503,2,30,30,0,858,863
7183.049,73,864,3,3,0,11.26959,0,40,40,0,861,864
7193.049,73,865,1,1,0,9.980788,0,40,40,0,864,865
7203.049,73,867,2,2,0,8.968981,0,40,40,0,865,867
7213.049,74,868,2,2,0,130.2032,1,20,20,0,866,868
7223.049,74,869,3,3,0,52.14051,1,20,20,0,866,869
7233.049,74,871,5,5,0,32.6627,1,20,20,0,866,871
7243.049,74,872,6,6,0,23.78192,2,30,30,0,866,872
7253.049,74,873,7,7,0,18.70721,2,30,30,0,866,873
7263.049,74,874,8,8,0,15.42357,2,30,30,0,866,874
7273.049,74,875,6,6,0,13.12503,0,40,40,0,869,875
7283.049,74,876,1,1,0,11.42611,0,40,40,0,875,876
7293.049,74,878,2,2,0,10.13079,0,40,40,0,876,878
7303.049,74,879,2,2,0,9.093119,1,20,20,0,877,879
7313.049,75,880,3,3,0,132.0032,1,20,20,0,877,880
7323.049,75,881,4,4,0,52.86052,1,20,20,0,877,881
7333.049,75,882,4,4,0,33.0752,2,30,30,0,878,882
7343.049,75,883,5,5,0,24.08192,2,30,30,0,878,883
7353.049,75,884,6,6,0,18.94292,2,30,30,0,878,884
7363.049,75,885,4,4,0,15.61769,0,40,40,0,881,885
7373.049,75,886,1,1,0,13.29003,0,40,40,0,885,886
7383.049,75,887,1,1,0,11.56959,0,40,40,0,886,887
7393.049,75,889,2,2,0,10.25771,1,20,20,0,887,889
7403.049,75,890,3,3,0,9.206912,1,20,20,0,887,890
7413.049,76,891,4,4,0,133.6533,1,20,20,0,887,891
7423.049,76,892,5,5,0,53.52052,2,30,30,0,887,892
7433.049,76,893,6,6,0,33.48771,2,30,30,0,887,893
7443.049,76,894,7,7,0,24.38193,2,30,30,0,887,894
7453.049,76,896,6,6,0,19.20007,0,40,40,0,890,896
7463.049,76,897,1,1,0,15.82946,0,40,40,0,896,897
7473.049,76,898,1,1,0,13.47003,0,40,40,0,897,898
7483.049,76,899,1,1,0,11.72611,1,20,20,0,898,899
7493.049,76,901,3,3,0,10.39617,1,20,20,0,898,901
7503.049,76,902,4,4,0,9.33105,1,20,20,0,898,902
7513.049,77,903,5,5,0,135.4533,2,30,30,0,898,903
7523.049,77,904,6,6,0,54.24053,2,30,30,0,898,904
7533.049,77,905,7,7,0,33.93771,2,30,30,0,898,905
7543.049,77,907,7,7,0,24.73647,0,40,40,0,900,907
7553.049,77,908,1,1,0,19.45721,0,40,40,0,907,908
7563.049,77,909,1,1,0,16.04122,0,40,40,0,908,909
7573.049,77,910,1,1,0,13.65003,1,20,20,0,909,910
7583.049,77,911,2,2,0,11.88263,1,20,20,0,909,911
7593.049,77,913,4,4,0,10.53464,1,20,20,0,909,913
7603.049,77,914,5,5,0,9.455189,2,30,30,0,909,914
7613.049,78,915,6,6,0,137.2534,2,30,30,0,909,915
7623.049,78,916,7,7,0,54.96054,2,30,30,0,909,916
7633.049,78,918,5,5,0,34.42521,0,40,40,0,913,918
7643.049,78,919,1,1,0,25.06375,0,40,40,0,918,919
7653.049,78,921,2,2,0,19.73578,0,40,40,0,919,921
7663.049,78,922,2,2,0,16.27064,1,20,20,0,920,922
7673.049,78,924,4,4,0,13.86003,1,20,20,0,920,924
7683.049,78,925,5,5,0,12.06524,1,20,20,0,920,925
7693.049,78,926,6,6,0,10.68464,2,30,30,0,920,926
7703.049,78,927,7,7,0,9.589671,2,30,30,0,920,927
7713.049,79,929,9,9,0,139.3534,2,30,30,0,920,929
7723.049,79,930,7,7,0,55.80054,0,40,40,0,923,930
7733.049,79,931,1,1,0,34.91271,0,40,40,0,930,931
7743.049,79,932,1,1,0,25.41829,0,40,40,0,931,932
7753.049,79,933,1,1,0,19.99293,1,20,20,0,932,933
7763.049,79,935,3,3,0,16.50005,1,20,20,0,932,935
7773.049,79,936,4,4,0,14.04003,1,20,20,0,932,936
7783.049,79,937,4,4,0,12.22177,2,30,30,0,933,937
7793.049,79,939,6,6,0,10.83464,2,30,30,0,933,939
7803.049,79,940,7,7,0,9.724154,2,30,30,0,933,940
7813.049,80,941,4,4,0,141.1534,0,40,40,0,937,941
7823.049,80,943,2,2,0,56.58055,0,40,40,0,941,943
7833.049,80,944,1,1,0,35.40022,0,40,40,0,943,944
7843.049,80,945,1,1,0,25.77284,1,20,20,0,944,945
7853.049,80,946,2,2,0,20.2715,1,20,20,0,944,946
7863.049,80,948,4,4,0,16.72946,1,20,20,0,944,948
7873.049,80,949,5,5,0,14.23503,2,30,30,0,944,949
7883.049,80,950,6,6,0,12.39133,2,30,30,0,944,950
7893.049,80,951,7,7,0,10.9731,2,30,30,0,944,951
7903.049,80,952,5,5,0,9.848292,0,40,40,0,947,952
7913.049,81,954,2,2,0,143.1035,0,40,40,0,952,954
7923.049,81,955,1,1,0,57.30056,0,40,40,0,954,955
7933.049,81,957,2,2,0,35.88772,1,20,20,0,955,957
7943.049,81,958,3,3,0,26.12739,1,20,20,0,955,958
7953.049,81,959,4,4,0,20.55007,1,20,20,0,955,959
7963.049,81,960,2,2,0,16.94123,2,30,30,0,958,960
7973.049,81,962,4,4,0,14.43004,2,30,30,0,958,962
7983.049,81,963,5,5,0,12.5609,2,30,30,0,958,963
7993.049,81,965,3,3,0,11.13464,0,40,40,0,962,965
8003.049,81,966,1,1,0,9.99312,0,40,40,0,965,966
8013.049,82,967,1,1,0,145.0535,0,40,40,0,966,967
8023.049,82,969,2,2,0,58.14057,1,20,20,0,967,969
8033.049,82,970,3,3,0,36.37522,1,20,20,0,967,970
8043.049,82,972,5,5,0,26.50921,1,20,20,0,967,972
8053.049,82,973,4,4,0,20.85007,2,30,30,0,969,973
8063.049,82,974,5,5,0,17.18828,2,30,30,0,969,974
8073.049,82,975,6,6,0,14.62504,2,30,30,0,969,975
8083.049,82,976,3,3,0,12.73046,0,40,40,0,973,976
8093.049,82,978,2,2,0,11.28464,0,40,40,0,976,978
8103.049,82,979,1,1,0,10.1276,0,40,40,0,978,979
8113.049,83,980,2,2,0,147.0036,1,20,20,0,978,980
8123.049,83,981,3,3,0,58.86058,1,20,20,0,978,981
8133.049,83,982,4,4,0,36.82523,1,20,20,0,978,982
8143.049,83,983,2,2,0,26.80921,2,30,30,0,981,983
8153.049,83,984,3,3,0,21.08579,2,30,30,0,981,984
8163.049,83,985,4,4,0,17.3824,2,30,30,0,981,985
8173.049,83,987,3,3,0,14.80504,0,40,40,0,984,987
8183.049,83,988,1,1,0,12.88698,0,40,40,0,987,988
8193.05,83,989,1,1,0,11.4115,0,40,40,0,988,989
8203.05,83,990,1,1,0,10.24134,1,20,20,0,989,990
8213.05,84,992,3,3,0,148.7927,1,20,20,0,989,992
8223.05,84,993,4,4,0,59.57883,1,20,20,0,989,993
8233.05,84,994,5,5,0,37.27454,2,30,30,0,989,994
8243.05,84,996,7,7,0,27.16339,2,30,30,0,989,996
8253.05,84,997,8,8,0,21.36414,2,30,30,0,989,997
8263.05,84,998,6,6,0,17.61166,0,40,40,0,992,998
8273.05,84,999,1,1,0,14.98493,0,40,40,0,998,999
8283.05,84,1000,1,1,0,13.04342,0,40,40,0,999,1000
8293.05,84,1001,1,1,0,11.54996,1,20,20,0,1000,1001
8303.05,84,1003,3,3,0,10.37583,1,20,20,0,1000,1003
8313.05,85,1004,4,4,0,150.5927,1,20,20,0,1000,1004
8323.05,85,1006,5,5,0,60.35882,2,30,30,0,1001,1006
8333.05,85,1007,6,6,0,37.76204,2,30,30,0,1001,1007
8343.05,85,1009,8,8,0,27.51794,2,30,30,0,1001,1009
8353.05,85,1010,7,7,0,21.64271,0,40,40,0,1003,1010
8363.05,85,1011,1,1,0,17.84107,0,40,40,0,1010,1011
8373.05,85,1012,1,1,0,15.17993,0,40,40,0,1011,1012
8383.05,85,1013,1,1,0,13.21299,1,20,20,0,1012,1013
8393.05,85,1015,3,3,0,11.71149,1,20,20,0,1012,1015
8403.05,85,1016,4,4,0,10.51031,1,20,20,0,1012,1016
8413.05,86,1017,5,5,0,152.5426,2,30,30,0,1012,1017
8423.05,86,1018,6,6,0,61.07881,2,30,30,0,1012,1018
8433.05,86,1019,7,7,0,38.21203,2,30,30,0,1012,1019
8443.05,86,1021,6,6,0,27.84521,0,40,40,0,1015,1021
8453.05,86,1022,1,1,0,21.89985,0,40,40,0,1021,1022
8463.05,86,1023,1,1,0,18.05284,0,40,40,0,1022,1023
8473.05,86,1025,2,2,0,15.37492,1,20,20,0,1023,1025
8483.05,86,1026,3,3,0,13.38255,1,20,20,0,1023,1026
8493.05,86,1027,4,4,0,11.84996,1,20,20,0,1023,1027
8503.05,86,1028,5,5,0,10.63445,2,30,30,0,1023,1028
8513.05,87,1030,7,7,0,154.4925,2,30,30,0,1023,1030
8523.05,87,1031,8,8,0,61.85879,2,30,30,0,1023,1031
8533.05,87,1032,5,5,0,38.69953,0,40,40,0,1027,1032
8543.05,87,1033,1,1,0,28.17248,0,40,40,0,1032,1033
8553.05,87,1034,1,1,0,22.15699,0,40,40,0,1033,1034
8563.05,87,1035,1,1,0,18.2646,1,20,20,0,1034,1035
8573.05,87,1037,3,3,0,15.55492,1,20,20,0,1034,1037
8583.05,87,1038,4,4,0,13.53907,1,20,20,0,1034,1038
8593.05,87,1039,4,4,0,11.98842,2,30,30,0,1035,1039
8603.05,87,1040,5,5,0,10.75858,2,30,30,0,1035,1040
8613.05,88,1041,6,6,0,156.1424,2,30,30,0,1035,1041
8623.05,88,1043,5,5,0,62.57878,0,40,40,0,1038,1043
8633.05,88,1044,1,1,0,39.14952,0,40,40,0,1043,1044
8643.05,88,1045,1,1,0,28.49975,0,40,40,0,1044,1045
8653.05,88,1046,2,2,0,22.41413,1,20,20,0,1044,1046
8663.05,88,1048,4,4,0,18.49401,1,20,20,0,1044,1048
8673.05,88,1049,5,5,0,15.73492,1,20,20,0,1044,1049
8683.05,88,1050,6,6,0,13.69559,2,30,30,0,1044,1050
8693.05,88,1051,7,7,0,12.12688,2,30,30,0,1044,1051
8703.05,88,1052,8,8,0,10.88272,2,30,30,0,1044,1052
8713.05,89,1053,6,6,0,157.9423,0,40,40,0,1047,1053
8723.05,89,1055,2,2,0,63.29876,0,40,40,0,1053,1055
8733.05,89,1056,1,1,0,39.59952,0,40,40,0,1055,1056
8743.05,89,1057,1,1,0,28.82702,1,20,20,0,1056,1057
8753.05,89,1058,2,2,0,22.67127,1,20,20,0,1056,1058
8763.05,89,1059,3,3,0,18.68813,1,20,20,0,1056,1059
8773.05,89,1060,4,4,0,15.89992,2,30,30,0,1056,1060
8783.05,89,1062,6,6,0,13.85211,2,30,30,0,1056,1062
8793.05,89,1063,7,7,0,12.26534,2,30,30,0,1056,1063
8803.05,89,1064,4,4,0,11.00686,0,40,40,0,1060,1064
8813.05,90,1065,1,1,0,159.7422,0,40,40,0,1064,1065
8823.05,90,1066,1,1,0,63.95875,0,40,40,0,1065,1066
8833.05,90,1067,1,1,0,40.01201,1,20,20,0,1066,1067
8843.05,90,1068,2,2,0,29.12701,1,20,20,0,1066,1068
8853.05,90,1069,3,3,0,22.90698,1,20,20,0,1066,1069
8863.05,90,1070,4,4,0,18.88224,2,30,30,0,1066,1070
8873.05,90,1071,5,5,0,16.06492,2,30,30,0,1066,1071
8883.05,90,1072,6,6,0,13.98255,2,30,30,0,1066,1072
8893.05,90,1073,4,4,0,12.38072,0,40,40,0,1069,1073
8903.05,90,1074,1,1,0,11.11031,0,40,40,0,1073,1074
8913.05,91,1076,2,2,0,161.3921,0,40,40,0,1074,1076
8923.05,91,1077,2,2,0,64.61874,1,20,20,0,1075,1077
8933.05,91,1078,3,3,0,40.42451,1,20,20,0,1075,1078
8943.05,91,1079,4,4,0,29.42701,1,20,20,0,1075,1079
8953.05,91,1080,3,3,0,23.1427,2,30,30,0,1077,1080
8963.05,91,1081,4,4,0,19.07636,2,30,30,0,1077,1081
8973.05,91,1083,6,6,0,16.24492,2,30,30,0,1077,1083
8983.05,91,1084,4,4,0,14.13907,0,40,40,0,1080,1084
8993.05,91,1085,1,1,0,12.51918,0,40,40,0,1084,1085
9003.05,91,1086,1,1,0,11.23444,0,40,40,0,1085,1086
9013.05,92,1088,2,2,0,163.192,1,20,20,0,1086,1088
9023.05,92,1089,3,3,0,65.33872,1,20,20,0,1086,1089
9033.05,92,1091,5,5,0,40.912,1,20,20,0,1086,1091
9043.05,92,1092,6,6,0,29.78155,2,30,30,0,1086,1092
9053.05,92,1093,7,7,0,23.42126,2,30,30,0,1086,1093
9063.05,92,1095,9,9,0,19.32342,2,30,30,0,1086,1095
9073.05,92,1096,7,7,0,16.43992,0,40,40,0,1089,1096
9083.05,92,1097,1,1,0,14.30863,0,40,40,0,1096,1097
9093.05,92,1098,1,1,0,12.66918,0,40,40,0,1097,1098
9103.05,92,1100,2,2,0,11.37927,1,20,20,0,1098,1100
9113.05,93,1101,3,3,0,165.1419,1,20,20,0,1098,1101
9123.05,93,1102,4,4,0,66.11871,1,20,20,0,1098,1102
9133.05,93,1103,1,1,0,41.362,2,30,30,0,1102,1103
9143.05,93,1104,2,2,0,30.10882,2,30,30,0,1102,1104
9153.05,93,1105,3,3,0,23.67841,2,30,30,0,1102,1105
9163.05,93,1106,1,1,0,19.51753,0,40,40,0,1105,1106
9173.05,93,1108,2,2,0,16.61992,0,40,40,0,1106,1108
9183.05,93,1109,1,1,0,14.46516,0,40,40,0,1108,1109
9193.05,93,1110,2,2,0,12.80764,1,20,20,0,1108,1110
9203.05,93,1111,3,3,0,11.49306,1,20,20,0,1108,1111
9213.05,94,1112,4,4,0,166.7919,1,20,20,0,1108,1112
9223.05,94,1113,5,5,0,66.77869,2,30,30,0,1108,1113
9233.05,94,1114,6,6,0,41.77449,2,30,30,0,1108,1114
9243.05,94,1115,7,7,0,30.40882,2,30,30,0,1108,1115
9253.05,94,1116,5,5,0,23.91412,0,40,40,0,1111,1116
9263.05,94,1117,1,1,0,19.71165,0,40,40,0,1116,1117
9273.05,94,1118,1,1,0,16.76992,0,40,40,0,1117,1118
9283.05,94,1119,1,1,0,14.59559,1,20,20,0,1118,1119
9293.05,94,1120,2,2,0,12.92303,1,20,20,0,1118,1120
9303.05,94,1121,3,3,0,11.59651,1,20,20,0,1118,1121
9313.05,95,1122,2,2,0,168.2918,2,30,30,0,1120,1122
9323.05,95,1123,3,3,0,67.37868,2,30,30,0,1120,1123
9333.05,95,1124,4,4,0,42.14949,2,30,30,0,1120,1124
9343.05,95,1125,1,1,0,30.68155,0,40,40,0,1124,1125
9353.05,95,1126,1,1,0,24.1284,0,40,40,0,1125,1126
9363.05,95,1127,1,1,0,19.88812,0,40,40,0,1126,1127
9373.05,95,1129,2,2,0,16.93492,1,20,20,0,1127,1129
9383.05,95,1130,3,3,0,14.73907,1,20,20,0,1127,1130
9393.05,95,1131,4,4,0,13.04995,1,20,20,0,1127,1131
9403.05,95,1132,5,5,0,11.71031,2,30,30,0,1127,1132
9413.05,96,1133,6,6,0,169.9417,2,30,30,0,1127,1133
9423.05,96,1134,7,7,0,68.03867,2,30,30,0,1127,1134
9433.05,96,1136,5,5,0,42.59948,0,40,40,0,1131,1136
9443.05,96,1137,1,1,0,31.00882,0,40,40,0,1136,1137
9453.05,96,1138,1,1,0,24.38554,0,40,40,0,1137,1138
9463.05,96,1139,2,2,0,20.09988,1,20,20,0,1137,1139
9473.05,96,1140,3,3,0,17.09992,1,20,20,0,1137,1140
9483.05,96,1142,5,5,0,14.89559,1,20,20,0,1137,1142
9493.05,96,1143,6,6,0,13.18841,2,30,30,0,1137,1143
9503.05,96,1144,7,7,0,11.83444,2,30,30,0,1137,1144
9513.05,97,1145,8,8,0,171.7416,2,30,30,0,1137,1145
9523.05,97,1146,5,5,0,68.75866,0,40,40,0,1141,1146
9533.05,97,1148,2,2,0,43.04947,0,40,40,0,1146,1148
9543.05,97,1149,1,1,0,31.33609,0,40,40,0,1148,1149
9553.05,97,1150,2,2,0,24.64268,1,20,20,0,1148,1150
9563.05,97,1151,3,3,0,20.31165,1,20,20,0,1148,1151
9573.05,97,1152,4,4,0,17.27991,1,20,20,0,1148,1152
9583.05,97,1154,5,5,0,15.05211,2,30,30,0,1149,1154
9593.05,97,1155,6,6,0,13.32687,2,30,30,0,1149,1155
9603.05,97,1156,7,7,0,11.95858,2,30,30,0,1149,1156
9613.05,98,1157,4,4,0,173.5415,0,40,40,0,1153,1157
9623.05,98,1158,1,1,0,69.47865,0,40,40,0,1157,1158
9633.05,98,1160,2,2,0,43.49947,0,40,40,0,1158,1160
9643.05,98,1161,2,2,0,31.66335,1,20,20,0,1159,1161
9653.05,98,1162,3,3,0,24.89983,1,20,20,0,1159,1162
9663.05,98,1163,4,4,0,20.52341,1,20,20,0,1159,1163
9673.05,98,1165,5,5,0,17.47491,2,30,30,0,1160,1165
9683.05,98,1166,6,6,0,15.20863,2,30,30,0,1160,1166
9693.05,98,1167,7,7,0,13.46533,2,30,30,0,1160,1167
9703.05,98,1168,6,6,0,12.08272,0,40,40,0,1162,1168
9713.05,99,1170,2,2,0,175.4914,0,40,40,0,1168,1170
9723.05,99,1171,1,1,0,70.25863,0,40,40,0,1170,1171
9733.05,99,1172,2,2,0,43.94946,1,20,20,0,1170,1172
9743.05,99,1173,3,3,0,31.99063,1,20,20,0,1170,1173
9753.05,99,1175,5,5,0,25.1784,1,20,20,0,1170,1175
9763.05,99,1176,6,6,0,20.75282,2,30,30,0,1170,1176
9773.05,99,1178,8,8,0,17.66991,2,30,30,0,1170,1178
9783.05,99,1179,9,9,0,15.3782,2,30,30,0,1170,1179
9793.05,99,1181,9,9,0,13.62687,0,40,40,0,1172,1181
9803.05,99,1182,1,1,0,12.22754,0,40,40,0,1181,1182
9813.05,100,1183,1,1,0,177.4413,0,40,40,0,1182,1183
9823.05,100,1184,1,1,0,71.03861,1,20,20,0,1183,1184
9833.05,100,1185,2,2,0,44.43696,1,20,20,0,1183,1185
9843.05,100,1187,4,4,0,32.37244,1,20,20,0,1183,1187
9853.05,100,1188,5,5,0,25.45696,2,30,30,0,1183,1188
9863.05,100,1190,7,7,0,20.99988,2,30,30,0,1183,1190
9873.05,100,1191,8,8,0,17.86491,2,30,30,0,1183,1191
9883.05,100,1192,6,6,0,15.54776,0,40,40,0,1186,1192
9893.05,100,1193,1,1,0,13.76533,0,40,40,0,1192,1193
9903.05,100,1194,1,1,0,12.35168,0,40,40,0,1193,1194
9913.05,101,1196,2,2,0,179.3912,1,20,20,0,1194,1196
9923.05,101,1197,3,3,0,71.8186,1,20,20,0,1194,1197
9933.05,101,1198,4,4,0,44.92445,1,20,20,0,1194,1198
9943.05,101,1200,6,6,0,32.72698,2,30,30,0,1194,1200
9953.05,101,1201,7,7,0,25.73553,2,30,30,0,1194,1201
9963.05,101,1202,8,8,0,21.21164,2,30,30,0,1194,1202
9973.05,101,1203,7,7,0,18.04491,0,40,40,0,1196,1203
9983.05,101,1204,1,1,0,15.70428,0,40,40,0,1203,1204
9993.05,101,1205,1,1,0,13.90379,0,40,40,0,1204,1205
10003.05,101,1206,1,1,0,12.47582,1,20,20,0,1205,1206
10013.05,102,1207,2,2,0,181.0412,1,20,20,0,1205,1207
10023.05,102,1209,4,4,0,72.53858,1,20,20,0,1205,1209
10033.05,102,1210,5,5,0,45.37445,2,30,30,0,1205,1210
10043.05,102,1211,6,6,0,33.02698,2,30,30,0,1205,1211
10053.05,102,1212,7,7,0,25.97125,2,30,30,0,1205,1212
10063.05,102,1214,6,6,0,21.42341,0,40,40,0,1208,1214
10073.05,102,1215,1,1,0,18.22491,0,40,40,0,1214,1215
10083.05,102,1216,1,1,0,15.8608,0,40,40,0,1215,1216
10093.05,102,1217,1,1,0,14.04226,1,20,20,0,1216,1217
10103.05,102,1219,3,3,0,12.6103,1,20,20,0,1216,1219
10113.05,103,1220,4,4,0,182.9911,1,20,20,0,1216,1220
10123.05,103,1222,5,5,0,73.31857,2,30,30,0,1217,1222
10133.05,103,1223,6,6,0,45.86194,2,30,30,0,1217,1223
10143.05,103,1224,7,7,0,33.38152,2,30,30,0,1217,1224
10153.05,103,1225,5,5,0,26.24982,0,40,40,0,1220,1225
10163.05,103,1226,1,1,0,21.63517,0,40,40,0,1225,1226
10173.05,103,1227,1,1,0,18.40491,0,40,40,0,1226,1227
10183.05,103,1228,1,1,0,16.01732,1,20,20,0,1227,1228
10193.05,103,1229,2,2,0,14.18072,1,20,20,0,1227,1229
10203.05,103,1230,3,3,0,12.7241,1,20,20,0,1227,1230
10213.05,104,1232,5,5,0,184.791,2,30,30,0,1227,1232
10223.05,104,1233,6,6,0,73.97855,2,30,30,0,1227,1233
10233.05,104,1234,7,7,0,46.27444,2,30,30,0,1227,1234
10243.05,104,1235,6,6,0,33.68152,0,40,40,0,1229,1235
10253.05,104,1237,2,2,0,26.50696,0,40,40,0,1235,1237
10263.05,104,1238,1,1,0,21.84693,0,40,40,0,1237,1238
10273.05,104,1239,1,1,0,18.58491,1,20,20,0,1238,1239
10283.05,104,1241,3,3,0,16.18689,1,20,20,0,1238,1241
10293.05,104,1242,4,4,0,14.33072,1,20,20,0,1238,1242
10303.05,104,1244,5,5,0,12.86892,2,30,30,0,1239,1244
10313.05,105,1245,6,6,0,186.7409,2,30,30,0,1239,1245
10323.05,105,1246,7,7,0,74.75854,2,30,30,0,1239,1246
10333.05,105,1248,7,7,0,46.79943,0,40,40,0,1241,1248
10343.05,105,1249,1,1,0,34.06334,0,40,40,0,1248,1249
10353.05,105,1250,1,1,0,26.78553,0,40,40,0,1249,1250
10363.05,105,1252,2,2,0,22.09399,1,20,20,0,1250,1252
10373.05,105,1253,3,3,0,18.79491,1,20,20,0,1250,1253
10383.05,105,1254,4,4,0,16.35645,1,20,20,0,1250,1254
10393.05,105,1255,5,5,0,14.48071,2,30,30,0,1250,1255
10403.05,105,1256,6,6,0,12.99306,2,30,30,0,1250,1256
10413.05,106,1257,7,7,0,188.5408,2,30,30,0,1250,1257
10423.05,106,1258,6,6,0,75.47852,0,40,40,0,1252,1258
10433.05,106,1260,2,2,0,47.24942,0,40,40,0,1258,1260
10443.05,106,1261,1,1,0,34.3906,0,40,40,0,1260,1261
10453.05,106,1262,1,1,0,27.04267,1,20,20,0,1261,1262
10463.05,106,1263,2,2,0,22.28811,1,20,20,0,1261,1263
10473.05,106,1264,3,3,0,18.95991,1,20,20,0,1261,1264
10483.05,106,1265,3,3,0,16.49993,2,30,30,0,1262,1265
10493.05,106,1266,4,4,0,14.60764,2,30,30,0,1262,1266
10503.05,106,1267,5,5,0,13.10685,2,30,30,0,1262,1267
10513.05,107,1269,5,5,0,190.3407,0,40,40,0,1264,1269
10523.05,107,1270,1,1,0,76.19851,0,40,40,0,1269,1270
10533.05,107,1271,1,1,0,47.66192,0,40,40,0,1270,1271
10543.05,107,1272,2,2,0,34.6906,1,20,20,0,1270,1272
10553.05,107,1273,3,3,0,27.27838,1,20,20,0,1270,1273
10563.05,107,1274,4,4,0,22.48222,1,20,20,0,1270,1274
10573.05,107,1276,4,4,0,19.13991,2,30,30,0,1272,1276
10583.05,107,1277,4,4,0,16.65645,2,30,30,0,1273,1277
10593.05,107,1278,5,5,0,14.7461,2,30,30,0,1273,1278
10603.05,107,1279,3,3,0,13.23099,0,40,40,0,1276,1279
10613.05,108,1280,1,1,0,191.9906,0,40,40,0,1279,1280
10623.05,108,1281,1,1,0,76.8585,0,40,40,0,1280,1281
10633.05,108,1282,1,1,0,48.07441,1,20,20,0,1281,1282
10643.05,108,1283,2,2,0,34.9906,1,20,20,0,1281,1283
10653.05,108,1285,4,4,0,27.53552,1,20,20,0,1281,1285
10663.05,108,1286,3,3,0,22.69399,2,30,30,0,1283,1286
10673.05,108,1287,4,4,0,19.3049,2,30,30,0,1283,1287
10683.05,108,1288,5,5,0,16.79993,2,30,30,0,1283,1288
10693.05,108,1289,2,2,0,14.87302,0,40,40,0,1287,1289
10703.05,108,1291,2,2,0,13.35513,0,40,40,0,1289,1291
10713.05,109,1292,1,1,0,193.7905,0,40,40,0,1291,1292
10723.05,109,1293,2,2,0,77.57848,1,20,20,0,1291,1293
10733.05,109,1294,3,3,0,48.52441,1,20,20,0,1291,1294
10743.05,109,1296,5,5,0,35.34514,1,20,20,0,1291,1296
10753.05,109,1297,5,5,0,27.79266,2,30,30,0,1292,1297
10763.05,109,1299,7,7,0,22.9234,2,30,30,0,1292,1299
10773.05,109,1300,8,8,0,19.4999,2,30,30,0,1292,1300
10783.05,109,1301,7,7,0,16.96949,0,40,40,0,1294,1301
